{
    "name": "第二关 - 挑战",
    "brick_width": 55,
    "brick_height": 22,
    "start_x": 80,
    "start_y": 60,
    "layout": [
        [1,0,1,0,1,0,1,0,1,0,1,0],
        [0,2,0,2,0,2,0,2,0,2,0,2],
        [1,0,1,0,1,0,1,0,1,0,1,0],
        [0,3,0,3,0,3,0,3,0,3,0,3],
        [2,0,2,0,2,0,2,0,2,0,2,0],
        [0,1,0,1,0,1,0,1,0,1,0,1]
    ]
}