{
    "name": "第一关 - 入门",
    "brick_width": 60,
    "brick_height": 25,
    "start_x": 100,
    "start_y": 50,
    "layout": [
        [1,1,1,1,1,1,1,1,1,1],
        [1,1,1,1,1,1,1,1,1,1],
        [2,2,2,2,2,2,2,2,2,2],
        [2,2,2,2,2,2,2,2,2,2],
        [3,3,3,3,3,3,3,3,3,3]
    ]
}