{
    "name": "第三关 - 高难度",
    "brick_width": 50,
    "brick_height": 20,
    "start_x": 50,
    "start_y": 40,
    "layout": [
        [4,4,4,4,4,4,4,4,4,4,4,4,4,4],
        [3,3,3,3,0,0,0,0,0,0,3,3,3,3],
        [2,2,2,0,1,1,1,1,1,1,0,2,2,2],
        [1,1,0,2,2,2,2,2,2,2,2,0,1,1],
        [0,0,3,3,3,3,3,3,3,3,3,3,0,0],
        [4,4,0,0,4,0,0,0,0,4,0,0,4,4]
    ]
}